050019
¡ñ¡ñ¡ñ¡ñ¡ñ¡ñ¡ñ¡ñ¡ñ¡ñ¡ñ¡ñ¡ñ¡ñ¡ñ¡ñ¡ñ¡ñ¡ñ¡ñ¡ñ¡ñ¡ñ¡ñ¡ñ
¡ô¡¡¡¡¡¡¡¡¡¡¡¡¡¡¡¡¡¡¡¡¡¡¡¡¡¡¡¡¡¡¡¡¡¡¡¡¡¡¡¡¡ñ¡ñ¡ñ¡ô
¡õ¡¡¡¡¡¡¡¡¡¡¡¡¡¡¡¡¡¡¡¡¡¡¡¡¡¡¡¡¡¡¡¡¡¡¡¡¡¡¡¡¡ñ¡ñ¡ñ¡õ
¡÷¡¡¡¡¡¡¡¡¡¡¡¡¡¡¡¡¡¡¡¡¡¡¡¡¡¡¡¡¡¡¡¡¡¡¡¡¡¡¡¡¡ñ¡ñ¡ñ¡÷
¡ø¡¡¡¡¡¡¡¡¡¡¡¡¡¡¡¡¡¡¡¡¡¡¡¡¡¡¡¡¡¡¡¡¡¡¡¡¡¡¡¡¡ñ¡ñ¡ñ¡ø
¡ö¡¡¡¡¡¡¡¡¡¡¡¡¡¡¡¡¡¡¡¡¡¡¡¡¡¡¡¡¡¡¡¡¡¡¡¡¡¡¡¡¡ñ¡ñ¡ñ¡ö
¡î¡¡¡¡¡¡¡¡¡¡¡¡¡¡¡¡¡¡¡¡¡¡¡¡¡¡¡¡¡¡¡¡¡¡¡¡¡¡¡¡¡ñ¡ñ¡ñ¡î
¡ï¡¡¡¡¡¡¡¡¡¡¡¡¡¡¡¡¡¡¡¡¡¡¡¡¡¡¡¡¡¡¡¡¡¡¡¡¡¡¡¡¡ñ¡ñ¡ñ¡ï
¡ó¡¡¡¡¡¡¡¡¡¡¡¡¡¡¡¡¡¡¡¡¡¡¡¡¡¡¡¡¡¡¡¡¡¡¡¡¡¡¡¡¡ñ¡ñ¡ñ¡ó
¡á¡¡¡¡¡¡¡¡¡¡¡¡¡¡¡¡¡¡¡¡¡¡¡¡¡¡¡¡¡¡¡¡¡¡¡¡¡¡¡¡¡ñ¡ñ¡ñ¡á
¡â¡¡¡¡¡¡¡¡¡¡¡¡¡¡¡¡¡¡¡¡¡¡¡¡¡¡¡¡¡¡¡¡¡¡¡¡¡¡¡¡¡ñ¡ñ¡ñ¡â
¡ñ¡¡¡¡¡¡¡¡¡¡¡¡¡¡¡¡¡¡¡¡¡¡¡¡¡¡¡¡¡¡¡¡¡¡¡¡¡¡¡¡¡ñ¡ñ¡ñ¡ñ
¡ô¡¡¡¡¡¡¡¡¡¡¡¡¡¡¡¡¡¡¡¡¡¡¡¡¡¡¡¡¡¡¡¡¡¡¡¡¡¡¡¡¡ñ¡ñ¡ñ¡ô
¡õ¡¡¡¡¡¡¡¡¡¡¡¡¡¡¡¡¡¡¡¡¡¡¡¡¡¡¡¡¡¡¡¡¡¡¡¡¡¡¡¡¡ñ¡ñ¡ñ¡õ
¡÷¡¡¡¡¡¡¡¡¡¡¡¡¡¡¡¡¡¡¡¡¡¡¡¡¡¡¡¡¡¡¡¡¡¡¡¡¡¡¡¡¡ñ¡ñ¡ñ¡÷
¡ø¡¡¡¡¡¡¡¡¡¡¡¡¡¡¡¡¡¡¡¡¡¡¡¡¡¡¡¡¡¡¡¡¡¡¡¡¡¡¡¡¡ñ¡ñ¡ñ¡ø
¡ö¡ö¡ö¡ö¡ö¡ö¡ö¡ö¡ö¡ö¡ö¡ö¡ö¡ö¡ö¡ö¡ö¡ö¡ö¡ö¡ö¡ñ¡ñ¡ñ¡ö
¡î¡î¡î¡î¡î¡î¡î¡î¡î¡î¡î¡î¡î¡î¡î¡î¡î¡î¡î¡î¡î¡ñ¡ñ¡ñ¡î
¡ï¡ï¡ï¡ï¡ï¡ï¡ï¡ï¡ï¡ï¡ï¡ï¡ï¡ï¡ï¡ï¡ï¡ï¡ï¡ï¡ï¡ï¡ï¡ï¡ï
¡î¡î¡î¡î¡î¡î¡î¡î¡î¡î¡î¡î¡î¡î¡î¡î¡î¡î¡î¡î¡î¡ñ¡ñ¡ñ¡î
¡ï¡ï¡ï¡ï¡ï¡ï¡ï¡ï¡ï¡ï¡ï¡ï¡ï¡ï¡ï¡ï¡ï¡ï¡ï¡ï¡ï¡ï¡ï¡ï¡ï