0005000019
¡ñ¡ñ¡ñ¡ñ¡ñ¡ñ¡ñ¡ñ¡ñ¡ñ¡ñ¡ñ¡ñ¡ñ¡ñ¡ñ¡ñ¡ñ¡ñ¡ñ¡ñ¡ñ¡ñ¡ñ¡ñ
¡ô¡ô¡ô¡ô¡ô¡ô¡ô¡ô¡ô¡ô¡ô¡ô¡ô¡ô¡ô¡ô¡ô¡ô¡ô¡ô¡ô¡ô¡ô¡ô¡ô
¡õ¡õ¡õ¡õ¡õ¡õ¡õ¡õ¡õ¡õ¡õ¡õ¡õ¡õ¡õ¡õ¡õ¡õ¡õ¡õ¡õ¡õ¡õ¡õ¡õ
¡÷¡÷¡÷¡÷¡÷¡÷¡÷¡÷¡÷¡÷¡÷¡÷¡÷¡÷¡÷¡÷¡÷¡÷¡÷¡÷¡÷¡÷¡÷¡÷¡÷
¡ø¡ø¡ø¡ø¡ø¡ø¡ø¡ø¡ø¡ø¡ø¡ø¡ø¡ø¡ø¡ø¡ø¡ø¡ø¡ø¡ø¡ø¡ø¡ø¡ø
¡ö¡ö¡ö¡ö¡ö¡ö¡ö¡ö¡ö¡ö¡ö¡ö¡ö¡ö¡ö¡ö¡ö¡ö¡ö¡ö¡ö¡ö¡ö¡ö¡ö
¡î¡î¡î¡î¡î¡î¡î¡î¡î¡î¡î¡î¡î¡î¡î¡î¡î¡î¡î¡î¡î¡î¡î¡î¡î
¡ï¡ï¡ï¡ï¡ï¡ï¡ï¡ï¡ï¡ï¡ï¡ï¡ï¡ï¡ï¡ï¡ï¡ï¡ï¡ï¡ï¡ï¡ï¡ï¡ï
¡ó¡ó¡ó¡ó¡ó¡ó¡ó¡ó¡ó¡ó¡ó¡ó¡ó¡ó¡ó¡ó¡ó¡ó¡ó¡ó¡ó¡ó¡ó¡ó¡ó
¡á¡á¡á¡á¡á¡á¡á¡á¡á¡á¡á¡á¡á¡á¡á¡á¡á¡á¡á¡á¡á¡á¡á¡á¡á
¡â¡â¡â¡â¡â¡â¡â¡â¡â¡â¡â¡â¡â¡â¡â¡â¡â¡â¡â¡â¡â¡â¡â¡â¡â
¡ñ¡ñ¡ñ¡ñ¡ñ¡ñ¡ñ¡ñ¡ñ¡ñ¡ñ¡ñ¡ñ¡ñ¡ñ¡ñ¡ñ¡ñ¡ñ¡ñ¡ñ¡ñ¡ñ¡ñ¡ñ
¡ô¡ô¡ô¡ô¡ô¡ô¡ô¡ô¡ô¡ô¡ô¡ô¡ô¡ô¡ô¡ô¡ô¡ô¡ô¡ô¡ô¡ô¡ô¡ô¡ô
¡õ¡õ¡õ¡õ¡õ¡õ¡õ¡õ¡õ¡õ¡õ¡õ¡õ¡õ¡õ¡õ¡õ¡õ¡õ¡õ¡õ¡õ¡õ¡õ¡õ
¡÷¡÷¡÷¡÷¡÷¡÷¡÷¡÷¡÷¡÷¡÷¡÷¡÷¡÷¡÷¡÷¡÷¡÷¡÷¡÷¡÷¡÷¡÷¡÷¡÷
¡ø¡ø¡ø¡ø¡ø¡ø¡ø¡ø¡ø¡ø¡ø¡ø¡ø¡ø¡ø¡ø¡ø¡ø¡ø¡ø¡ø¡ø¡ø¡ø¡ø
¡ö¡ö¡ö¡ö¡ö¡ö¡ö¡ö¡ö¡ö¡ö¡ö¡ö¡ö¡ö¡ö¡ö¡ö¡ö¡ö¡ö¡ö¡ö¡ö¡ö
¡î¡î¡î¡î¡î¡î¡î¡î¡î¡î¡î¡î¡î¡î¡î¡î¡î¡î¡î¡î¡î¡î¡î¡î¡î
¡ï¡ï¡ï¡ï¡ï¡ï¡ï¡ï¡ï¡ï¡ï¡ï¡ï¡ï¡ï¡ï¡ï¡ï¡ï¡ï¡ï¡ï¡ï¡ï¡ï