050019
¡ñ¡ñ¡ñ¡ñ¡ñ¡ñ¡ñ¡ñ¡ñ¡ñ¡ñ¡ñ¡ñ¡ñ¡ñ¡ñ¡ñ¡ñ¡ñ¡ñ¡ñ¡ñ¡ñ¡ñ¡ñ
¡ô¡¡¡¡¡ñ¡ñ¡ñ¡¡¡¡¡¡¡¡¡¡¡¡¡¡¡¡¡¡¡¡¡¡¡¡¡¡¡¡¡¡¡¡¡ñ¡ñ¡ô
¡õ¡¡¡ñ¡¡¡¡¡¡¡ñ¡¡¡¡¡¡¡¡¡¡¡¡¡¡¡¡¡¡¡¡¡¡¡¡¡¡¡¡¡¡¡ñ¡ñ¡õ
¡÷¡¡¡ñ¡¡¡¡¡¡¡ñ¡¡¡¡¡¡¡¡¡¡¡¡¡¡¡¡¡¡¡¡¡¡¡¡¡¡¡¡¡¡¡ñ¡ñ¡÷
¡ø¡¡¡¡¡ñ¡ñ¡ñ¡¡¡¡¡¡¡¡¡¡¡¡¡¡¡¡¡¡¡¡¡¡¡¡¡¡¡¡¡¡¡¡¡ñ¡ñ¡ø
¡ö¡¡¡¡¡¡¡ñ¡¡¡¡¡¡£ª£ª£ª£ª£ª¡¡¡¡¡¡¡¡¡¡¡¡¡¡¡¡¡¡¡ñ¡ñ¡ö
¡î¡¡¡¡¡¡¡ñ¡¡¡¡¡¡£ª£ª£ª£ª£ª¡¡¡¡¡¡¡¡¡¡¡¡¡¡¡¡¡¡¡ñ¡ñ¡î
¡ï¡¡¡¡¡¡¡¡¡¡¡¡¡¡£ª£ª£ª£ª£ª¡¡¡¡¡¡¡¡¡¡¡¡¡¡¡¡¡¡¡ñ¡ñ¡ï
¡ó¡¡¡¡¡¡¡¡¡¡¡¡¡¡£ª£ª£ª£ª£ª¡¡¡¡¡¡¡¡¡¡¡¡¡¡¡¡¡¡¡ñ¡ñ¡ó
¡á¡¡¡¡¡¡¡¡¡¡¡¡¡¡£ª£ª£ª£ª£ª¡¡¡¡¡¡¡¡¡¡¡¡¡¡¡¡¡¡¡ñ¡ñ¡á
¡â¡¡¡¡¡¡¡¡¡¡¡¡¡¡¡¡¡¡¡¡¡¡¡¡¡¡¡¡¡¡¡¡¡¡¡¡¡¡¡¡¡¡¡ñ¡ñ¡â
¡ñ¡¡¡¡¡¡¡¡¡¡¡¡¡¡¡¡¡¡¡¡¡¡¡¡¡¡¡¡¡¡¡¡¡¡¡¡¡¡¡¡¡¡¡ñ¡ñ¡ñ
¡ô¡¡¡¡¡¡¡¡¡¡¡¡¡¡¡¡¡¡¡¡¡¡¡¡¡¡¡¡¡¡¡¡¡¡¡¡¡¡¡¡¡¡¡ñ¡ñ¡ô
¡õ¡¡¡¡¡¡¡¡¡¡¡¡¡¡¡¡¡¡¡¡¡¡¡¡¡¡¡¡¡¡¡¡¡¡¡¡¡¡¡¡¡¡¡ñ¡ñ¡õ
¡÷¡¡¡¡¡¡¡¡¡¡¡¡¡¡¡¡¡¡¡¡¡¡¡¡¡¡¡¡¡¡¡¡¡¡¡¡¡¡¡¡¡¡¡ñ¡ñ¡÷
¡ø¡¡¡¡¡¡¡¡¡¡¡¡¡¡¡¡¡¡¡¡¡¡¡¡¡¡¡¡¡¡¡¡¡¡¡¡¡¡¡¡¡¡¡ñ¡ñ¡ø
¡ö¡ö¡ö¡ö¡ö¡ö¡ö¡ö¡ö¡ö¡ö¡ö¡ö¡ö¡ö¡ö¡ö¡ö¡ö¡ö¡ö¡ñ¡ñ¡ñ¡ö
¡î¡î¡î¡î¡î¡î¡î¡î¡î¡î¡î¡î¡î¡î¡î¡î¡î¡î¡î¡î¡î¡ñ¡ñ¡ñ¡î
¡ï¡ï¡ï¡ï¡ï¡ï¡ï¡ï¡ï¡ï¡ï¡ï¡ï¡ï¡ï¡ï¡ï¡ï¡ï¡ï¡ï¡ï¡ï¡ï¡ï